0000000000000000000000000000000022000000000000000000000000000000000000000000000000000000000000000000
0000000000000000000000022200002222200000000000000000000000000000000000000000000000000000000000000000
0000000000000000000000221220022111220000000000000000000000000000000000000000000000000000000000000000
0000000000000000000002211122221111122000000000000000000000000000000000000000000000000000000000000000
0000000000000000000022111111111111112200000000000000000000000000000000000000000000000000000000000000
0000000000000000000221112221111111122000000000000000000000000000000000000000000000000000000000000000
0000000000000000000221112021111111120000000000000000000000000000000000000000000000000000000000000000
0000000000000000002021112221111111120000000000000000000000000000020000000000000000000000000000000000
0000000000000000202221111111111111120000000000000000000000000000220000000000000000000000000000000000
0000000000000002000211122211111111120000000000000000000000000000220000000000000000000000000000000000
0000000000000002222211220222111111120000000000000000000000000000022000000000000000000000000000000000
0000000000000002222211200002211111120000000000000000000000000000002002000022000000000000000000000000
0000000000000222000211200000211111120000000000002200000002000000222244400000000000000000000000000000
0000000000000212222211220000211111120000000000022220000022000004244444442002200444442222000000000000
0000000000000222120211122000211111220000200000221200000020020024444444444444244444411122000000000000
0000002222002202122211112200211111200002200200211220000020222444144444414444444444442220000000000000
0000022312222222111311222200211122200000002200222120222222211434444444144444444444202000000000000000
0000021134444444411311202220221220000000002220002222211411111344114114414444444440002200000000000000
0000021133344441111111202120021200000000000000200214414411111111444341314444411122022000000000000000
0000021111441331311222222220022200000000002222222211114114144414444411344444441112022000000000000000
0000022222224411444200021200022000000000002241341413344111411343414141311344111122002000000000000000
0000002200022144341200021220000000000000000224222231441114411134131114331441112220000000000000000000
0000000000002311311222021120000000000000000220220222222222111141111113111144122002000000000000000000
0000000000002114144442221122000000000000000000020020002202111441111311111444120022000000000000000000
0000000000002211144144131112000000000000002220020222222202141441131111144424220020000000000000000000
0000000000000221414444114422200000000000002322000222211224411443313131411120220020000000000000000000
0000000000000024144434142220000000000000002112200000211144144444414141111120002020000000000000000000
0000000000000221144131122000000000000000002111222222211222222144144111311120022000000000000000000000
0000000000000021113111120000000000000000022111111111111200002244422113112220000000000000000000000000
0000000000000022143111220000000000000000021111111111112200000212002211222000000000000000000000000000
0000000000000002111322200000000000000000021111111111122000000222000221200000000000000000000000000000
0000000000000002211202200000000000000000021111111111120000000022000022200020000000000000000000000000
0000000000000000221200000000000000000000022111111131122000000002000020200020000000000000000000000000
0000000000000000022222022000000000000000002222211131220000000000000020000202000000000000000000000000
0000000000000000002222000000000000000000000000211441200000000000000022002200000000000000000000000000
0000000000000000000002202440000000000000000000214443200000000000000002202222000000000000000000000000
0000000000000000000000222442000000000000000000221441200200000000000000022002002222000000000000000000
0000000000000000000000021444440000000000000000024441200220000000000000000000000212200000000000000000
0000000000000000000000021444444000000000000000024444202200000000000000000000000222220000000000000000
0000000000000000000000021444444420000000000000221442202200000000000000000000000200000000000000000000
0000000000000000000000021144444420000000000000024412000000000000000000000000022220200000000000000000
0000000000000000000000022143444400000000000000024122000000000000000000000000221122220000000000000000
0000000000000000000000002214414200000000000000022220000000000000000000000002211111120000000000000000
0000000000000000000000000214422200000000000000022000000000000000000000000222111141122000000000000000
0000000000000000000000000234440000000000000000000000000000000000000000000211111414112200000000000000
0000000000000000000000000211220000000000000000000000000000000000000000000221111111141200000100000000
0000000000000000000000002212200000000000000000000000000000000000000000000021111311111200000000000000
0000000000000000000000002122000000000000000000000000000000000000000000000022222221332200000200000000
0000000000000000000000002120000000000000000000000000000000000000000000000022000021112000000200000000